|-----------------------------------------------------------------------------|
|                                                                             |
| |--------------------------|        |-----------------------|               |
| |..........................|        |.......................|               |
| |..........................+########+.......................|-------|       |
| |..........................|        |...............................|--|    |
| |..........................|        |..................................|--| |
| |----------+---------------|        |----+----------------|...............| |
|            #                 #############                |...............| |
|            #                 #     |-----+------|         |...............| |
|            #                 #     |............|         |...............| |
|            ###################     |............|   ######+...............| |
|            #                 #     |............|   #     |...............| |
|            #                 #     |-----+------|   #     |--------+------| |
|  |---------+-----------|     #           #          #              #        |
|  |.....................|     #           #          #         |----+------| |
|  |.....................|     ########################         |...........| |
|  |.....................|                 #                    |...........| |
|  |.....................|          |------+--------------------|...........| |
|  |.....................|          |.......................................| |
|  |.....................+##########+.......................................| |
|  |.....................|          |.......................................| |
|  |--+------+-----------|          |------+----------------|...............| |
|     #      #                 #############                |...............| |
|  |--+---|  #                 #     |-----+------|         |...............| |
|  |......|  #                 #     |............|         |...............| |
|  |......+#####################     |............|   ######+...............| |
|  |------|  #                 #     |............|   #     |...............| |
|            #                 #     |-----+------|   #     |--------+------| |
|  |---------+-----------|     #           #          #              #        |
|  |.....................|     #           #          #         |----+------| |
|  |.....................|     ########################         |...........| |
|  |.....................|     #           #                    |...........| |
|  |.....................|     #    |------+--------------------|...........| |
|  |.....................|     #    |.......................................| |
|  |.....................+##########+.......................................| |
|  |.....................|          |.......................................| |
|  |---------------------|          |---------------------------------------| |
|                                                                             |
|-----------------------------------------------------------------------------|
|-----------------------------------------------------------------------------|
|                                                                             |
|               |-----------------------|        |--------------------------| |
|               |.......................|        |..........................| |
|       |-------|.......................+########+..........................| |
|    |--|...............................|        |..........................| |
| |--|..................................|        |..........................| |
| |...............|----------------+----|        |---------------+----------| |
| |...............|                #############                 #            |
| |...............|         |------+-----|     #                 #            |
| |...............|         |............|     #                 #            |
| |...............+######   |............|     ###################            |
| |...............|     #   |............|     #                 #            |
| |------+--------|     #   |------+-----|     #                 #            |
|        #              #          #           #     |-----------+---------|  |
| |------+----|         #          #           #     |.....................|  |
| |...........|         ########################     |.....................|  |
| |...........|                    #                 |.....................|  |
| |...........|--------------------+------|          |.....................|  |
| |.......................................|          |.....................|  |
| |.......................................+##########+.....................|  |
| |.......................................|          |.....................|  |
| |...............|----------------+------|          |-----------+------+--|  |
| |...............|                #############                 #      #     |
| |...............|         |------+-----|     #                 #  |---+--|  |
| |...............|         |............|     #                 #  |......|  |
| |...............+######   |............|     #####################+......|  |
| |...............|     #   |............|     #                 #  |------|  |
| |------+--------|     #   |------+-----|     #                 #            |
|        #              #          #           #     |-----------+---------|  |
| |------+----|         #          #           #     |.....................|  |
| |...........|         ########################     |.....................|  |
| |...........|                    #           #     |.....................|  |
| |...........|--------------------+------|    #     |.....................|  |
| |.......................................|    #     |.....................|  |
| |.......................................+##########+.....................|  |
| |.......................................|          |.....................|  |
| |---------------------------------------|          |---------------------|  |
|                                                                             |
|-----------------------------------------------------------------------------|
